11111111111111111111111111
1E000000000000000C00000001
10100101000010100000010101
10100010101001000000010101
1P0000C0C000000000000000C1
11111111111111111111111111